......W.............
....WWWWW...........
........W...........
........W...........
........W......F....
........WWWWWWWWW...
....................
....................
....................
......WWWWW.........
....................
....................
....................
....................
....................
....................
..........WWWWWWWW..
....................
....................
...C................