.......W.F
.......W..
..........
...WWWW...
.........W
WWW.......
..........
......W...
......W...
C.....W...