..........
..........
....WWW...
.....W....
.....W....
.....W....
.....W....
.....W....
..C..W..F.
.....W....