.......W.F
..........
..........
..........
..........
..........
..........
......W...
C.....W...
