......W.............
....WWWWW....F......
........W...........
........W...........
........W...........
........WWWWWWWWW...
....................
....................
....................
......WWWWW.........
....................
....................
....................
....................
....................
....................
..........WWWWWWWW..
....................
....................
..C.................