.........E
.N........
..........
.....E....
E.........
.......E..
..........
..........
.......N..
C.........